25 25 25 25 25 25 25 25 25 25 25 25 25 25 25 25 25 25 25 25 25 25 25 25 25 25 25 25 25 25 25 25 25 25 25 25 25 25 25 25 25 25 25 25 25 25 25 25 25 25 
25 25 25 25 25 25 25 25 25 25 25 25 25 25 25 25 25 25 25 25 25 25 25 25 25 25 25 25 25 25 25 25 25 25 25 25 25 25 25 25 25 25 25 25 25 25 25 25 25 25 
25 25 25 25 25 25 25 25 25 25 25 25 25 25 25 25 25 25 25 25 25 25 25 25 25 25 25 25 25 25 25 25 25 25 25 25 25 25 25 25 25 25 25 25 25 25 25 25 25 25 
25 25 25 25 25 25 25 25 25 25 25 25 25 25 25 25 25 25 25 25 25 25 25 25 25 25 25 25 25 25 25 25 25 25 25 25 25 25 25 25 25 25 25 25 25 25 25 25 25 25 
25 25 25 25 25 25 25 25 25 25 25 25 25 25 25 25 25 25 25 25 25 25 25 25 25 25 25 25 25 25 25 25 25 25 25 25 25 25 25 25 25 25 25 25 25 25 25 25 25 25 
25 25 25 25 25 25 25 25 25 25 25 25 25 25 25 25 25 25 25 25 25 25 25 25 25 25 25 25 25 25 25 25 25 25 25 25 25 25 25 25 25 25 25 25 25 25 25 25 25 25 
25 25 25 25 25 25 25 25 25 25 25 25 25 25 25 25 25 25 25 25 25 25 25 25 25 25 25 25 25 25 25 25 25 25 25 25 25 25 25 25 25 25 25 25 25 25 25 25 25 25 
25 25 25 25 25 25 25 25 25 17 17 17 25 25 25 25 25 25 25 25 25 25 25 25 25 25 35 7 17 17 25 17 17 17 25 25 17 17 17 17 17 25 25 25 25 25 25 25 25 25
25 25 25 25 25 25 25 25 25 17 17 17 17 25 25 25 25 25 25 25 25 25 25 25 25 25 32 20 17 17 17 17 25 17 25 25 17 25 25 25 17 25 25 25 25 25 25 25 25 25
25 25 25 25 25 25 25 25 25 17 17 17 17 17 17 17 17 17 17 17 17 17 17 25 25 25 25 17 25 17 17 17 25 25 25 25 17 25 25 17 17 25 25 25 25 25 25 25 25 25
25 25 25 25 25 25 25 25 25 17 17 17 27 34 34 34 34 34 34 34 34 29 17 25 25 25 25 17 17 17 17 25 25 25 25 25 17 25 25 17 25 25 25 25 25 25 25 25 25 25 
25 25 25 25 25 25 25 25 25 25 25 25 17 17 17 17 17 17 17 17 17 15 17 25 25 25 25 25 17 0 25 25 25 25 25 25 17 17 25 17 25 25 25 25 25 25 25 25 25 25 
25 25 25 25 25 25 25 25 25 25 25 25 25 25 25 25 25 25 25 25 17 15 17 25 25 25 25 25 25 15 25 25 25 25 25 25 25 17 25 17 17 25 25 25 25 25 25 25 25 25 
25 25 25 25 25 25 25 25 25 25 25 25 25 25 25 25 25 25 25 25 17 15 17 25 25 25 25 25 25 15 25 25 17 25 25 25 25 17 25 25 17 25 25 25 25 25 25 25 25 25 
25 25 25 25 25 25 25 25 25 25 16 26 26 26 26 26 26 21 25 25 17 15 17 25 25 25 25 25 25 15 25 25 17 25 25 25 25 17 25 25 17 25 25 25 25 25 25 25 25 25 
25 25 25 25 25 25 25 25 25 25 14 25 17 17 17 17 17 6 25 25 17 15 17 25 25 25 25 25 25 15 25 25 17 17 25 25 25 17 25 17 17 25 25 25 25 25 25 25 25 25
25 25 25 25 25 25 25 25 25 25 14 17 17 18 34 34 29 6 25 25 17 15 17 25 25 25 25 25 25 15 25 25 25 17 17 25 25 17 25 17 25 25 25 25 25 25 25 25 25 25 
25 25 25 25 25 25 25 25 25 25 13 5 3 15 33 5 31 4 25 25 17 15 17 25 25 25 25 25 25 15 25 25 25 25 17 25 25 17 25 17 25 25 25 25 25 25 25 25 25 25 
25 25 25 25 25 25 25 25 25 25 17 8 14 15 6 17 15 17 25 25 17 15 17 25 25 25 25 25 25 15 25 25 25 25 17 17 17 17 25 17 25 25 25 25 25 25 25 25 25 25 
25 25 25 25 25 25 25 25 25 17 17 17 14 15 6 17 15 17 25 25 17 15 17 25 25 25 25 25 25 15 25 25 25 25 25 17 25 17 25 17 25 25 25 25 25 25 25 25 25 25 
25 25 25 25 25 25 25 25 25 17 17 17 14 15 6 17 15 17 25 25 17 15 17 25 25 17 17 17 17 15 17 17 17 25 25 17 25 17 25 17 17 25 25 25 25 25 25 25 25 25 
25 25 25 25 25 25 25 25 25 17 17 17 14 15 6 17 19 17 25 25 17 15 17 25 25 17 18 34 34 22 34 34 28 17 17 17 25 17 25 25 17 25 25 25 25 25 25 25 25 25 
25 25 25 25 25 25 25 25 25 17 17 17 14 19 6 17 17 17 25 25 17 15 17 25 25 17 15 17 17 15 17 17 17 25 25 25 25 17 17 25 17 25 25 25 25 25 25 25 25 25 
25 25 25 25 25 25 25 25 25 17 17 17 13 5 4 17 17 17 25 25 17 15 17 25 25 17 15 17 25 15 25 25 25 25 25 25 25 25 25 25 17 25 25 25 25 25 25 25 25 25 
25 25 25 25 25 25 25 25 25 17 25 17 17 17 25 17 17 17 17 17 17 15 17 17 17 17 15 17 25 15 25 25 25 25 25 25 25 25 25 25 17 25 25 25 25 25 25 25 25 25 
25 25 25 25 25 25 25 25 25 17 17 17 17 17 17 17 17 17 27 34 34 22 34 34 34 34 11 17 25 19 25 25 17 17 17 17 17 17 17 17 17 25 25 25 25 25 25 25 25 25 
25 25 25 25 25 25 25 25 25 17 17 17 17 17 17 17 17 17 17 17 17 15 17 17 17 17 17 17 25 25 25 25 17 25 25 25 25 25 17 25 25 25 25 25 25 25 25 25 25 25 
25 25 25 25 25 25 25 25 25 17 17 17 17 17 17 25 17 17 25 25 17 15 17 25 25 25 25 25 25 25 25 25 17 17 25 25 17 25 17 17 25 25 25 25 25 25 25 25 25 25 
25 25 25 25 25 25 25 25 25 17 17 17 25 17 17 17 17 17 25 25 17 15 17 25 25 25 25 25 25 25 25 25 25 17 17 17 17 25 25 17 25 25 25 25 25 25 25 25 25 25 
25 25 25 25 25 25 25 25 25 17 17 17 17 17 17 17 17 17 25 25 17 15 17 25 25 25 25 25 25 25 25 25 25 17 25 25 25 25 25 17 25 25 25 25 25 25 25 25 25 25 
25 25 25 25 25 25 25 25 25 17 25 17 17 17 17 17 17 17 25 25 17 15 17 25 25 25 25 25 25 25 17 17 17 17 17 25 25 25 17 17 17 25 25 25 25 25 25 25 25 25 
25 25 25 25 25 25 25 25 25 17 17 17 17 17 25 17 17 17 25 25 17 15 17 25 25 25 25 25 25 25 25 25 17 25 17 25 17 25 17 25 17 25 25 25 25 25 25 25 25 25 
25 25 25 25 25 25 25 25 25 35 7 17 17 17 17 17 17 17 25 25 17 15 17 25 25 25 25 25 25 25 25 25 17 17 17 25 17 25 17 25 17 25 25 25 25 25 25 25 25 25 
25 25 25 25 25 25 25 25 25 1 10 7 17 17 17 17 17 17 25 25 17 15 17 25 25 25 25 25 25 25 25 25 25 25 25 25 17 17 17 25 25 25 25 25 25 25 25 25 25 25 
25 25 25 25 25 25 25 25 25 1 24 2 17 17 17 17 25 17 25 25 17 15 17 25 25 25 25 25 25 25 25 25 25 25 25 25 25 25 25 25 25 25 25 25 25 25 25 25 25 25 
25 25 25 25 25 25 25 25 25 1 24 2 17 25 17 17 17 17 25 25 17 15 17 25 25 25 25 25 25 25 25 25 25 25 25 25 25 25 25 25 25 25 25 25 25 25 25 25 25 25
25 25 25 25 25 25 25 25 25 1 24 10 7 17 17 17 17 17 25 25 17 15 17 25 25 25 25 25 25 25 25 25 25 25 25 25 25 25 25 25 25 25 25 25 25 25 25 25 25 25 
25 25 25 25 25 25 25 25 25 1 24 24 10 7 17 17 17 17 25 25 17 15 17 17 17 17 17 17 17 17 17 17 17 17 17 17 17 25 17 17 17 25 25 25 25 25 25 25 25 25 
25 25 25 25 25 25 25 25 25 32 9 24 24 10 7 17 17 25 25 25 17 12 34 34 34 34 34 34 34 30 34 34 34 34 34 29 17 25 17 17 17 25 25 25 25 25 25 25 25 25 
25 25 25 25 25 25 25 25 25 25 32 23 9 24 10 7 25 25 25 25 17 17 17 17 17 17 17 17 17 15 17 17 17 17 17 15 17 17 17 17 17 25 25 25 25 25 25 25 25 25
25 25 25 25 25 25 25 25 25 17 17 17 32 9 24 2 25 25 25 25 17 25 25 25 25 25 25 25 25 15 25 25 25 25 17 12 34 28 17 17 25 25 25 25 25 25 25 25 25 25
25 25 25 25 25 25 25 25 25 17 17 17 17 32 23 20 25 25 25 25 17 25 25 25 25 25 25 25 25 15 25 25 25 25 17 17 17 17 17 17 17 25 25 25 25 25 25 25 25 25
25 25 25 25 25 25 25 25 25 17 17 17 17 17 17 17 17 17 17 17 17 25 25 25 25 25 25 25 25 19 25 25 25 25 25 25 25 25 25 17 8 25 25 25 25 25 25 25 25 25
25 25 25 25 25 25 25 25 25 25 25 25 25 25 25 25 25 25 25 25 25 25 25 25 25 25 25 25 25 25 25 25 25 25 25 25 25 25 25 25 25 25 25 25 25 25 25 25 25 25 
25 25 25 25 25 25 25 25 25 25 25 25 25 25 25 25 25 25 25 25 25 25 25 25 25 25 25 25 25 25 25 25 25 25 25 25 25 25 25 25 25 25 25 25 25 25 25 25 25 25 
25 25 25 25 25 25 25 25 25 25 25 25 25 25 25 25 25 25 25 25 25 25 25 25 25 25 25 25 25 25 25 25 25 25 25 25 25 25 25 25 25 25 25 25 25 25 25 25 25 25 
25 25 25 25 25 25 25 25 25 25 25 25 25 25 25 25 25 25 25 25 25 25 25 25 25 25 25 25 25 25 25 25 25 25 25 25 25 25 25 25 25 25 25 25 25 25 25 25 25 25 
25 25 25 25 25 25 25 25 25 25 25 25 25 25 25 25 25 25 25 25 25 25 25 25 25 25 25 25 25 25 25 25 25 25 25 25 25 25 25 25 25 25 25 25 25 25 25 25 25 25 
25 25 25 25 25 25 25 25 25 25 25 25 25 25 25 25 25 25 25 25 25 25 25 25 25 25 25 25 25 25 25 25 25 25 25 25 25 25 25 25 25 25 25 25 25 25 25 25 25 25 
25 25 25 25 25 25 25 25 25 25 25 25 25 25 25 25 25 25 25 25 25 25 25 25 25 25 25 25 25 25 25 25 25 25 25 25 25 25 25 25 25 25 25 25 25 25 25 25 25 25 
