29 29 29 29 29 29 29 29 29 29 29 29 29 29 29 29 28 28 28 28 28 28 28 28 28 28 28 28 28 28 28 28 28 28 28 28 28 28 28 28 28 28 28 28 28 28 28 28 28 28 
29 139 163 163 163 163 163 163 163 163 163 163 163 163 163 163 163 163 163 163 163 163 163 163 163 163 163 163 163 163 163 163 163 163 163 163 163 163 163 163 163 163 163 163 163 163 163 163 138 28 
29 137 0 0 0 0 0 0 0 0 0 0 0 0 0 0 28 28 28 28 28 28 28 28 28 28 28 28 28 28 28 28 28 28 28 28 28 28 28 28 28 28 28 28 28 28 28 28 135 28 
29 137 0 0 0 0 0 0 0 0 0 0 0 0 0 0 28 28 28 28 28 28 28 28 28 28 28 28 28 28 28 28 28 28 28 28 28 28 28 28 28 28 28 28 28 28 28 28 135 28 
29 137 0 0 0 0 0 0 0 0 0 0 0 0 0 0 28 28 28 28 28 28 28 28 28 28 28 28 28 28 28 28 28 28 28 28 28 28 28 28 28 28 28 28 28 28 28 28 135 28 
29 137 0 0 0 0 0 0 0 0 0 0 0 0 0 0 28 28 28 28 28 28 28 28 28 28 28 28 28 28 28 28 28 28 28 28 28 28 28 28 28 28 28 28 28 28 28 28 135 28 
29 137 0 0 0 0 0 0 0 0 0 0 0 28 0 0 28 28 28 28 28 28 28 28 28 28 28 28 28 28 28 28 28 28 28 28 28 28 28 28 28 28 28 28 28 28 28 28 135 28 
0 137 0 0 0 0 0 0 0 0 0 0 0 0 28 28 28 28 28 28 28 28 28 28 28 28 28 28 28 28 28 28 28 28 28 28 28 28 28 28 28 28 28 28 28 28 28 28 135 28 
0 137 0 0 0 0 0 0 0 0 0 0 0 0 0 0 28 28 28 28 28 28 28 28 28 28 28 28 28 28 28 28 28 28 28 28 28 28 28 28 28 28 28 28 28 28 28 28 135 28 
28 137 28 28 28 28 28 28 28 28 28 28 28 28 28 28 28 28 28 28 28 28 28 28 28 28 28 28 28 28 28 28 28 28 28 28 28 28 28 28 28 28 28 28 28 28 28 28 135 28 
28 137 28 28 28 28 28 28 28 28 28 28 28 28 28 28 28 28 28 28 28 28 28 28 28 28 28 28 28 28 28 28 28 28 28 28 28 28 28 28 28 28 28 28 28 28 28 28 135 28 
28 137 28 28 28 28 28 28 28 28 28 28 28 28 28 28 28 28 28 28 28 28 28 28 28 28 28 28 28 28 28 28 28 28 28 28 28 28 28 28 28 28 28 28 28 28 28 28 135 28 
28 137 28 28 28 28 28 28 28 28 28 28 28 28 28 28 28 28 28 28 28 28 28 28 28 28 28 28 28 28 28 28 28 28 28 28 28 28 28 28 28 28 28 28 28 28 28 28 135 28 
28 137 28 28 28 28 28 28 28 28 28 28 28 28 28 28 28 28 28 28 28 28 28 28 28 28 28 28 28 28 28 28 28 28 28 28 28 28 28 28 28 28 28 28 28 28 28 28 135 28 
28 137 28 28 28 28 28 28 28 28 28 28 28 28 28 28 28 28 28 28 28 28 28 28 28 28 28 28 28 28 28 28 28 28 28 28 28 28 28 28 28 28 28 28 28 28 28 28 135 28 
28 137 28 28 28 28 28 28 28 28 28 28 28 28 28 28 28 28 28 28 28 28 28 28 28 28 28 28 28 28 28 28 28 28 28 28 28 28 28 28 28 28 28 28 28 28 28 28 135 28 
28 137 28 28 28 28 28 28 28 28 28 28 28 28 28 28 28 28 28 28 28 28 439 278 441 28 28 28 28 28 28 28 28 28 28 28 28 28 28 28 28 28 28 28 28 28 28 28 135 28 
28 137 28 28 28 28 28 28 28 28 28 28 28 28 28 28 28 28 28 28 439 278 388 305 389 278 278 441 28 28 28 28 28 28 28 28 28 28 28 28 28 28 28 28 28 28 28 28 135 28 
28 137 28 28 28 28 28 28 28 28 28 28 28 28 28 28 28 28 28 439 442 305 305 305 305 305 305 389 278 278 278 441 28 28 28 28 28 28 28 28 28 28 28 28 28 28 28 28 135 28 
28 137 28 28 28 28 28 28 28 28 28 28 28 28 28 28 28 439 278 388 305 305 535 536 536 375 305 305 305 305 305 389 278 441 28 28 28 28 28 28 28 28 28 28 28 28 28 28 135 28 
28 137 28 28 28 28 28 28 28 28 28 28 28 28 28 28 439 442 305 305 305 535 538 320 320 377 374 374 374 375 305 305 305 387 28 28 28 28 28 28 28 28 28 28 28 28 28 28 135 28 
28 137 28 28 28 28 28 28 28 28 28 28 28 28 439 278 388 305 305 535 536 538 320 320 320 320 320 320 320 377 374 375 305 389 278 441 28 28 28 28 28 28 28 28 28 28 28 28 135 28 
28 137 28 28 28 28 28 28 28 28 28 28 439 278 388 305 305 305 535 538 320 320 320 320 320 320 320 320 320 320 320 321 305 305 305 389 278 441 28 28 28 28 28 28 28 28 28 28 135 28 
28 137 28 28 28 28 28 28 28 28 28 439 442 305 305 305 535 536 538 320 320 320 320 320 320 320 320 320 320 320 320 377 374 375 305 305 305 443 441 28 28 28 28 28 28 28 28 28 135 28 
28 137 28 28 28 28 28 28 28 28 439 442 305 305 535 536 538 320 320 320 320 320 320 320 320 320 320 320 320 320 320 320 320 377 375 305 305 305 387 28 28 28 28 28 28 28 28 28 135 28 
28 137 28 28 28 28 28 28 28 28 466 305 305 535 538 320 320 320 320 320 320 320 320 320 320 320 320 320 320 320 320 320 320 320 321 305 305 362 414 28 28 28 28 28 28 28 28 28 135 28 
28 137 28 28 28 28 28 28 28 28 466 305 305 562 320 320 320 320 320 320 320 320 320 320 320 320 320 320 320 320 320 320 320 320 321 305 305 468 28 28 28 28 28 28 28 28 28 28 135 28 
28 137 28 28 28 28 28 28 28 28 412 361 305 562 320 320 320 320 320 320 320 320 320 320 320 320 320 320 320 320 320 320 320 320 321 305 362 414 28 28 28 28 28 28 28 28 28 28 135 28 
28 137 28 28 28 28 28 28 28 28 28 466 305 508 565 320 320 320 320 320 320 320 320 320 320 320 320 320 320 320 320 320 320 320 321 305 468 28 28 28 28 28 28 28 28 28 28 28 135 28 
28 137 28 28 28 28 28 28 28 28 28 466 305 305 562 320 320 320 320 320 320 320 320 320 320 320 320 320 320 320 320 320 320 320 321 305 335 441 28 28 28 28 28 28 28 28 28 28 135 28 
28 137 28 28 28 28 28 28 28 28 28 412 361 305 562 320 320 320 320 320 320 320 320 320 320 320 320 320 320 320 320 320 404 428 591 305 305 468 28 28 28 28 28 28 28 28 28 28 135 28 
28 137 28 28 28 28 28 28 28 28 28 28 466 305 508 509 565 320 320 320 320 320 320 320 320 320 320 320 320 320 320 404 591 305 305 305 470 414 28 28 28 28 28 28 28 28 28 28 135 28 
28 137 28 28 28 28 28 28 28 28 28 28 466 305 305 305 508 565 320 320 320 320 320 320 320 320 320 320 320 320 320 402 305 305 470 332 333 28 28 28 28 28 28 28 28 28 28 28 135 28 
28 137 28 28 28 28 28 28 28 28 28 28 412 332 361 305 305 508 509 565 320 320 320 320 320 320 320 320 404 428 428 591 305 470 333 28 28 28 28 28 28 28 28 28 28 28 28 28 135 28 
28 137 28 28 28 28 28 28 28 28 28 28 28 28 412 469 305 305 305 508 509 565 320 320 320 404 428 428 591 305 305 305 362 333 28 28 28 28 28 28 28 28 28 28 28 28 28 28 135 28 
28 137 28 28 28 28 28 28 28 28 28 28 28 28 28 412 332 361 305 305 305 508 590 590 590 591 305 305 305 305 362 332 414 28 28 28 28 28 28 28 28 28 28 28 28 28 28 28 135 28 
28 137 28 28 28 28 28 28 28 28 28 28 28 28 28 28 28 412 332 361 305 305 305 305 305 305 305 362 332 332 414 28 28 28 28 28 28 28 28 28 28 28 28 28 28 28 28 28 135 28 
28 137 28 28 28 28 28 28 28 28 28 28 28 28 28 28 28 28 28 412 332 361 305 305 362 332 332 414 28 28 28 28 28 28 28 28 28 28 28 28 28 28 28 28 28 28 28 28 135 28 
28 137 28 28 28 28 28 28 28 28 28 28 28 28 28 28 28 28 28 28 28 412 332 332 414 28 28 28 28 28 28 28 28 28 28 28 28 28 28 28 28 28 28 28 28 28 28 28 135 28 
28 137 28 28 28 28 28 28 28 28 28 28 28 28 28 28 28 28 28 28 28 28 28 28 28 28 28 28 28 28 28 28 28 28 28 28 28 28 28 28 28 28 28 28 28 28 28 28 135 28 
28 137 28 28 28 28 28 28 28 28 28 28 28 28 28 28 28 28 28 28 28 28 28 28 28 28 28 28 28 28 28 28 28 28 28 28 28 28 28 28 28 28 28 28 28 28 28 28 135 28 
28 137 28 28 28 28 28 28 28 28 28 28 28 28 28 28 28 28 28 28 28 28 28 28 28 28 28 28 28 28 28 28 28 28 28 28 28 28 28 28 28 28 28 28 28 28 28 28 135 28 
28 137 28 28 28 28 28 28 28 28 28 28 28 28 28 28 28 28 28 28 28 28 28 28 28 28 28 28 28 28 28 28 28 28 28 28 28 28 28 28 28 28 28 28 28 28 28 28 135 28 
28 137 28 28 28 28 28 28 28 28 28 28 28 28 28 28 28 28 28 28 28 28 28 28 28 28 28 28 28 28 28 28 28 28 28 28 28 28 28 28 28 28 28 28 28 28 28 28 135 28 
28 137 28 28 28 28 28 28 28 28 28 28 28 28 28 28 28 28 28 28 28 28 28 28 28 28 28 28 28 28 28 28 28 28 28 28 28 28 28 28 28 28 28 28 28 28 28 28 135 28 
28 137 28 28 28 28 28 28 28 28 28 28 28 28 28 28 28 28 28 28 28 28 28 28 28 28 28 28 28 28 28 28 28 28 28 28 28 28 28 28 28 28 28 28 28 28 28 28 135 28 
28 137 28 28 28 28 28 28 28 28 28 28 28 28 28 28 28 28 28 28 28 28 28 28 28 28 28 28 28 28 28 28 28 28 28 28 28 28 28 28 28 28 28 28 28 28 28 28 135 28 
28 137 28 28 28 28 28 28 28 28 28 28 28 28 28 28 28 28 28 28 28 28 28 28 28 28 28 28 28 28 28 28 28 28 28 28 28 28 28 28 28 28 28 28 28 28 28 28 135 28 
28 112 109 109 109 109 109 109 109 109 109 109 109 109 109 109 109 109 109 109 109 109 109 110 28 28 108 109 109 109 109 109 109 109 109 109 109 109 109 109 109 109 109 109 109 109 109 109 111 28 
28 28 28 28 28 28 28 28 28 28 28 28 28 28 28 28 28 28 28 28 28 28 28 137 28 28 135 28 28 28 28 28 28 28 28 28 28 28 28 28 28 28 28 28 28 28 28 28 28 28 
